-6,-21,-25,-25,-25,-25,-22,-25,-25,-23,-21,-17,-19,-19
12,-5,-15,-14,-11,-8,-7,-8,-6,-8,-7,-5,-4,-4
27,15,5,7,5,5,5,5,5,4,5,5,5,5
45,38,27,24,24,23,22,21,24,23,20,18,13,13
68,57,50,50,48,51,49,50,42,47,42,46,42,42
84,78,73,74,73,73,70,65,63,71,62,55,57,57
97,101,95,94,98,96,99,91,92,86,81,76,71,71
130,131,131,130,131,131,131,131,121,110,98,87,78,78
130,131,131,130,131,131,131,131,121,110,98,87,78,78
130,131,131,130,131,131,131,131,121,110,98,87,78,78
130,131,131,130,131,131,131,131,121,110,98,87,78,78